1111111111111
1P0011E00*0C1
1C110000000C1
1P0011E0030C1
1111111111111
